11111111111
1P1100C0E01
10000000001
1M00000M001
11111111111