111111111111111111111111111
100000001000000001000000111
111100101011011111000000111
100100000000010001000000001
10010000P000010001000000011
100000000000010001000011111
111110111111110000001111111
111111111111111111111111111