111111111111111111111
10P000000000001000111
100000000000001000111
111111111000001000001
100000001000001000011
100010001000011000001
111110000000000000001
111111111111111111111