111111111111111111111
100000100000001000111
100000100000001000111
100000100000001000001
10000010P100001000011
100000100000011000001
111110111111110000001
111111111111111111111