111111111111111111111111111
100000000000000000000000111
100000000000000000000000111
100000000000000000000000001
10000000P000000000000000011
100000000000000000000000001
111110111111110000001111111
111111111111111111111111111