11111111111111111111111111
11P00011111110000000000011
110110011111100000M0011011
100M000000000000000E000011
11111110111110011110001101
11C11110111110011100000011
11000000111110011111111011
11C10110111110000000111011
1000000C000000C0000C111011
11111111111110111111111C11
11111111111110111111111011
11000011111110011111111001
11011001111110000000111101
1000000C000000000000000M01
11111111111110C0000C111011
11111111111110111111111011
11111111111110111111111C01
11000011111110011111111101
11011001111110000000111101
1000000C000000000000000001
11111111111110111111111111
11111111111110111111111111
100000000000000C00000C0001
10100101001000001010010001
10100100101010100010010001
100000000C00C0000000000001
11111111111111111111111111