111111111111111111111111111111
10P000010000000000100000010001
111110010010111010111111010101
100000010110110000111111010101
101111110010110000100000010101
100000000000110111100011110001
111000011111110000110000000011
100000000000010000000000000001
111111111111111111111111111111